bag - сумка
ball - мяч
bank - банк
basin - бассейн
basket - корзина
bath - ванна
bed - кровать
bee - пчела
bell - колокольчик
berry - ягода
bird - птица
blade - лезвие
board - доска
boat - лодка
bone - кость
book - книга
boot - ботинок
bottle - бутылка
box - коробка
boy - мальчик
brain - мозг
brake - тормоз
branch - ветвь
brick - кирпич
bridge - мост
brush - щётка
bucket - ведро
bulb - луковица
button - кнопка
baby - ребёнок